﻿..................................
..................................
...#############################..
...#...........................#..
...#...........................#..
...#...........................#..
...#...........................#..
...#...........................#..
...#.....##############........#..
...#...........................#..
...#...........................#..
...#...........................#..
...#...........................#..
...#...........................#..
...#############################..
..................................
..................................
..................................
..................................
..................................
..................................
..................................
..................................
..................................
..................................
..................................
..................................
..................................
..................................
..................................
..................................
..................................
..................................
..................................
..................................